公司	省市
九江银行股份有限公司	江西省无;九江市无
九江银行股份有限公司庐山支行	江西省无;九江市无
九江银行股份有限公司白水湖支行	江西省无;九江市无
九江银行股份有限公司滨江支行	江西省无;九江市无
九江银行股份有限公司滨兴支行	江西省无;九江市无
九江银行股份有限公司柴桑支行	江西省无;九江市无
九江银行股份有限公司大校场支行	江西省无;九江市无
九江银行股份有限公司大中路支行	江西省无;九江市无
九江银行股份有限公司甘棠支行	江西省无;九江市无
九江银行股份有限公司公园支行	江西省无;九江市无
九江银行股份有限公司光华支行	江西省无;九江市无
九江银行股份有限公司九龙支行	江西省无;九江市无
九江银行股份有限公司开发区支行	江西省无;九江市无
九江银行股份有限公司湓浦支行	江西省无;九江市无
九江银行股份有限公司三里街支行	江西省无;九江市无
九江银行股份有限公司十里支行	江西省无;九江市无
九江银行股份有限公司长虹支行	江西省无;九江市无
九江银行股份有限公司长江支行	江西省无;九江市无
九江银行股份有限公司振劳支行	江西省无;九江市无
九江银行股份有限公司瑞昌支行	江西省无;九江市无
九江银行股份有限公司德安支行	江西省无;九江市无
九江银行股份有限公司修水支行	江西省无;九江市无
九江银行股份有限公司永修支行	江西省无;九江市无
九江银行股份有限公司沙河支行	江西省无;九江市无
九江银行股份有限公司都昌支行	江西省无;九江市无
九江银行股份有限公司彭泽支行	江西省无;九江市无
九江银行股份有限公司浔阳支行	江西省无;九江市无
九江银行股份有限公司共青支行	江西省无;九江市无
九江银行股份有限公司武宁支行	江西省无;九江市无
九江银行股份有限公司星子支行	江西省无;九江市无
九江银行股份有限公司湖口支行	江西省无;九江市无
九江银行股份有限公司小企业信贷中心	江西省无;九江市无
九江银行股份有限公司湓城支行	江西省无;九江市无
九江银行股份有限公司八里湖支行	江西省无;九江市无
九江银行股份有限公司城北支行	江西省无;九江市无
九江银行股份有限公司建昌支行	江西省无;九江市无
九江银行股份有限公司开发区社区支行	江西省无;九江市无
九江银行股份有限公司十里老街社区支行	江西省无;九江市无
九江银行股份有限公司江州支行	江西省无;九江市无
九江银行股份有限公司石化总厂社区支行	江西省无;九江市无
九江银行股份有限公司怡康社区支行	江西省无;九江市无
九江银行股份有限公司湖口台山社区支行	江西省无;九江市无
九江银行股份有限公司都昌金都社区支行	江西省无;九江市无
九江银行股份有限公司浔东支行	江西省无;九江市无
九江银行股份有限公司九龙社区支行	江西省无;九江市无
九江银行股份有限公司蒲亭支行	江西省无;九江市无
九江银行股份有限公司南大社区支行	江西省无;九江市无
九江银行股份有限公司花果园社区支行	江西省无;九江市无
九江银行股份有限公司临江市场社区支行	江西省无;九江市无
九江银行股份有限公司万里支行	江西省无;九江市无
九江银行股份有限公司湖滨社区支行	江西省无;九江市无
九江银行股份有限公司豫宁支行	江西省无;九江市无
九江银行股份有限公司长虹社区支行	江西省无;九江市无
九江银行股份有限公司七零七社区支行	江西省无;九江市无
九江银行股份有限公司万达社区支行	江西省无;九江市无
九江银行股份有限公司水岸莲华社区支行	江西省无;九江市无
九江银行股份有限公司九龙新城社区支行	江西省无;九江市无
九江银行股份有限公司抚州分行	江西省无;抚州市无
九江银行股份有限公司崇仁支行	江西省无;抚州市无
九江银行股份有限公司临川支行	江西省无;抚州市无
九江银行股份有限公司南丰支行	江西省无;抚州市无
九江银行股份有限公司金溪支行	江西省无;抚州市无
九江银行股份有限公司乐安支行	江西省无;抚州市无
九江银行股份有限公司东乡支行	江西省无;抚州市无
九江银行股份有限公司抚州马家山广场社区支行	江西省无;抚州市无
九江银行股份有限公司抚州凤凰城社区支行	江西省无;抚州市无
九江银行股份有限公司抚州西湖绿洲社区支行	江西省无;抚州市无
九江银行股份有限公司抚州羊城路社区支行	江西省无;抚州市无
九江银行股份有限公司东乡宏鑫社区支行	江西省无;抚州市无
九江银行股份有限公司黎川支行	江西省无;抚州市无
九江银行股份有限公司广昌支行	江西省无;抚州市无
九江银行股份有限公司临川唱凯社区支行	江西省无;抚州市无
九江银行股份有限公司崇仁永胜社区支行	江西省无;抚州市无
九江银行股份有限公司南城支行	江西省无;抚州市无
九江银行股份有限公司宜黄支行	江西省无;抚州市无
九江银行股份有限公司抚州文昌桥社区支行	江西省无;抚州市无
九江银行股份有限公司抚州瑶坪南路社区支行	江西省无;抚州市无
九江银行股份有限公司资溪支行	江西省无;抚州市无
九江银行股份有限公司赣州分行	江西省无;赣州市无
九江银行股份有限公司赣州文清路社区支行	江西省无;赣州市无
九江银行股份有限公司赣州黄屋坪路社区支行	江西省无;赣州市无
九江银行股份有限公司赣州迎宾大道社区支行	江西省无;赣州市无
九江银行股份有限公司赣州国际时代广场社区支行	江西省无;赣州市无
九江银行股份有限公司赣州大公路社区支行	江西省无;赣州市无
九江银行股份有限公司赣州东阳山路社区支行	江西省无;赣州市无
九江银行股份有限公司赣州五洲大道社区支行	江西省无;赣州市无
九江银行股份有限公司赣州红旗大道社区支行	江西省无;赣州市无
九江银行股份有限公司赣州沙河大道社区支行	江西省无;赣州市无
九江银行股份有限公司于都支行	江西省无;赣州市无
九江银行股份有限公司信丰支行	江西省无;赣州市无
九江银行股份有限公司赣县支行	江西省无;赣州市无
九江银行股份有限公司全南支行	江西省无;赣州市无
九江银行股份有限公司宁都支行	江西省无;赣州市无
九江银行股份有限公司瑞金支行	江西省无;赣州市无
九江银行股份有限公司赣州蓉江小微支行	江西省无;赣州市无
九江银行股份有限公司龙南支行	江西省无;赣州市无
九江银行股份有限公司兴国支行	江西省无;赣州市无
九江银行股份有限公司安远支行	江西省无;赣州市无
九江银行股份有限公司上犹支行	江西省无;赣州市无
九江银行股份有限公司赣州南康东门社区支行	江西省无;赣州市无
九江银行股份有限公司赣州章江小微支行	江西省无;赣州市无
九江银行股份有限公司会昌支行	江西省无;赣州市无
九江银行股份有限公司大余支行	江西省无;赣州市无
九江银行股份有限公司寻乌支行	江西省无;赣州市无
九江银行股份有限公司广州分行	广东省无;广州市无
九江银行股份有限公司广州荔湾支行	广东省无;广州市无
九江银行股份有限公司广州海珠支行	广东省无;广州市无
九江银行股份有限公司广州广园支行	广东省无;广州市无
九江银行股份有限公司广州环市支行	广东省无;广州市无
九江银行股份有限公司广州天平装饰材料城社区支行	广东省无;广州市无
九江银行股份有限公司广州海印支行	广东省无;广州市无
九江银行股份有限公司广州江湾社区支行	广东省无;广州市无
九江银行股份有限公司广州金融街社区支行	广东省无;广州市无
九江银行股份有限公司广州江南支行	广东省无;广州市无
九江银行股份有限公司广州番禺支行	广东省无;广州市无
九江银行股份有限公司广州建设路社区支行	广东省无;广州市无
九江银行股份有限公司广州开发区支行	广东省无;广州市无
九江银行股份有限公司广州华景新城社区支行	广东省无;广州市无
九江银行股份有限公司广州怡乐路社区支行	广东省无;广州市无
九江银行股份有限公司广州番禺万达广场社区支行	广东省无;广州市无
九江银行股份有限公司广东自贸试验区南沙支行	广东省无;广州市无
九江银行股份有限公司广州增城支行	广东省无;广州市无
九江银行股份有限公司合肥分行	安徽省无;合肥市无
九江银行股份有限公司合肥瑶海支行	安徽省无;合肥市无
九江银行股份有限公司合肥望江西路支行	安徽省无;合肥市无
九江银行股份有限公司庐江支行	安徽省无;合肥市无
九江银行股份有限公司合肥包河支行	安徽省无;合肥市无
九江银行股份有限公司合肥屯溪路支行	安徽省无;合肥市无
九江银行股份有限公司合肥金潜支行	安徽省无;合肥市无
九江银行股份有限公司合肥西园新村社区支行	安徽省无;合肥市无
九江银行股份有限公司肥西支行	安徽省无;合肥市无
九江银行股份有限公司合肥世纪家园社区支行	安徽省无;合肥市无
九江银行股份有限公司合肥碧湖花园社区支行	安徽省无;合肥市无
九江银行股份有限公司庐江学苑小区社区支行	安徽省无;合肥市无
九江银行股份有限公司合肥当涂路支行	安徽省无;合肥市无
九江银行股份有限公司合肥万绿园社区支行	安徽省无;合肥市无
九江银行股份有限公司合肥蓝色湖畔社区支行	安徽省无;合肥市无
九江银行股份有限公司合肥临泉东路支行	安徽省无;合肥市无
九江银行股份有限公司吉安分行	江西省无;吉安市无
九江银行股份有限公司泰和支行	江西省无;吉安市无
九江银行股份有限公司安福支行	江西省无;吉安市无
九江银行股份有限公司吉州支行	江西省无;吉安市无
九江银行股份有限公司吉水支行	江西省无;吉安市无
九江银行股份有限公司新干支行	江西省无;吉安市无
九江银行股份有限公司永新支行	江西省无;吉安市无
九江银行股份有限公司青原支行	江西省无;吉安市无
九江银行股份有限公司永丰支行	江西省无;吉安市无
九江银行股份有限公司安福安成社区支行	江西省无;吉安市无
九江银行股份有限公司新干城南社区支行	江西省无;吉安市无
九江银行股份有限公司吉安北门社区支行	江西省无;吉安市无
九江银行股份有限公司吉水龙华社区支行	江西省无;吉安市无
九江银行股份有限公司泰和中山社区支行	江西省无;吉安市无
九江银行股份有限公司青原天和社区支行	江西省无;吉安市无
九江银行股份有限公司广场支行	江西省无;吉安市无
九江银行股份有限公司吉安支行	江西省无;吉安市无
九江银行股份有限公司遂川支行	江西省无;吉安市无
九江银行股份有限公司吉安白塘小微支行	江西省无;吉安市无
九江银行股份有限公司吉安阳明小微支行	江西省无;吉安市无
九江银行股份有限公司吉安井开区小微支行	江西省无;吉安市无
九江银行股份有限公司万安支行	江西省无;吉安市无
九江银行股份有限公司峡江支行	江西省无;吉安市无
九江银行股份有限公司井冈山支行	江西省无;吉安市无
九江银行股份有限公司景德镇分行	江西省无;景德镇无
九江银行股份有限公司乐平支行	江西省无;景德镇无
九江银行股份有限公司昌南支行	江西省无;景德镇无
九江银行股份有限公司珠山支行	江西省无;景德镇无
九江银行股份有限公司新厂支行	江西省无;景德镇无
九江银行股份有限公司景德镇乐平福泰华庭社区支行	江西省无;景德镇无
九江银行股份有限公司景德镇昌河社区支行	江西省无;景德镇无
九江银行股份有限公司洎阳支行	江西省无;景德镇无
九江银行股份有限公司景德镇戴家弄社区支行	江西省无;景德镇无
九江银行股份有限公司浮梁支行	江西省无;景德镇无
九江银行股份有限公司景德镇人民公园社区支行	江西省无;景德镇无
九江银行股份有限公司景德镇梨树园社区支行	江西省无;景德镇无
九江银行股份有限公司南昌分行	江西省无;南昌市无
九江银行股份有限公司洪城支行	江西省无;南昌市无
九江银行股份有限公司南昌县支行	江西省无;南昌市无
九江银行股份有限公司洪都大道支行	江西省无;南昌市无
九江银行股份有限公司进贤县支行	江西省无;南昌市无
九江银行股份有限公司高新支行	江西省无;南昌市无
九江银行股份有限公司阳明支行	江西省无;南昌市无
九江银行股份有限公司新建支行	江西省无;南昌市无
九江银行股份有限公司青云支行	江西省无;南昌市无
九江银行股份有限公司南昌洪都社区支行	江西省无;南昌市无
九江银行股份有限公司南昌万科四季花城社区支行	江西省无;南昌市无
九江银行股份有限公司南昌名门世家社区支行	江西省无;南昌市无
九江银行股份有限公司南昌贤士花园社区支行	江西省无;南昌市无
九江银行股份有限公司南昌鹿璟名居社区支行	江西省无;南昌市无
九江银行股份有限公司南昌象湖居住主题公园社区支行	江西省无;南昌市无
九江银行股份有限公司南昌星加坡花园社区支行	江西省无;南昌市无
九江银行股份有限公司安义县支行	江西省无;南昌市无
九江银行股份有限公司南昌莱卡小镇社区支行	江西省无;南昌市无
九江银行股份有限公司南昌铁路八村社区支行	江西省无;南昌市无
九江银行股份有限公司八一支行	江西省无;南昌市无
九江银行股份有限公司进贤新辉社区支行	江西省无;南昌市无
九江银行股份有限公司南昌桃苑社区支行	江西省无;南昌市无
九江银行股份有限公司安义新河湾社区支行	江西省无;南昌市无
九江银行股份有限公司北京东路支行	江西省无;南昌市无
九江银行股份有限公司南昌坛子口社区支行	江西省无;南昌市无
九江银行股份有限公司南昌系马桩社区支行	江西省无;南昌市无
九江银行股份有限公司南昌南钢社区支行	江西省无;南昌市无
九江银行股份有限公司南昌象南社区支行	江西省无;南昌市无
九江银行股份有限公司南昌中山路社区支行	江西省无;南昌市无
九江银行股份有限公司南昌博览路社区支行	江西省无;南昌市无
九江银行股份有限公司南昌文教路社区支行	江西省无;南昌市无
九江银行股份有限公司南昌江大南路小微支行	江西省无;南昌市无
九江银行股份有限公司萍乡分行	江西省无;萍乡市无
九江银行股份有限公司莲花支行	江西省无;萍乡市无
九江银行股份有限公司芦溪支行	江西省无;萍乡市无
九江银行股份有限公司湘东支行	江西省无;萍乡市无
九江银行股份有限公司萍乡城南社区支行	江西省无;萍乡市无
九江银行股份有限公司萍乡万龙湾社区支行	江西省无;萍乡市无
九江银行股份有限公司上栗支行	江西省无;萍乡市无
九江银行股份有限公司萍乡开发区支行	江西省无;萍乡市无
九江银行股份有限公司上饶分行	江西省无;上饶市人社局没有搜索栏，行政处罚公示栏无2018.6以来的相关信息
九江银行股份有限公司上饶滨江西路社区支行	江西省无;上饶市人社局没有搜索栏，行政处罚公示栏无2018.7以来的相关信息
九江银行股份有限公司广丰支行	江西省无;上饶市人社局没有搜索栏，行政处罚公示栏无2018.8以来的相关信息
九江银行股份有限公司余干支行	江西省无;上饶市人社局没有搜索栏，行政处罚公示栏无2018.9以来的相关信息
九江银行股份有限公司万年支行	江西省无;上饶市人社局没有搜索栏，行政处罚公示栏无2018.10以来的相关信息
九江银行股份有限公司上饶水南街社区支行	江西省无;上饶市人社局没有搜索栏，行政处罚公示栏无2018.11以来的相关信息
九江银行股份有限公司上饶带湖路社区支行	江西省无;上饶市人社局没有搜索栏，行政处罚公示栏无2018.12以来的相关信息
九江银行股份有限公司上饶明珠广场社区支行	江西省无;上饶市人社局没有搜索栏，行政处罚公示栏无2018.13以来的相关信息
九江银行股份有限公司上饶中山路社区支行	江西省无;上饶市人社局没有搜索栏，行政处罚公示栏无2018.14以来的相关信息
九江银行股份有限公司上饶县支行	江西省无;上饶市人社局没有搜索栏，行政处罚公示栏无2018.15以来的相关信息
九江银行股份有限公司德兴支行	江西省无;上饶市人社局没有搜索栏，行政处罚公示栏无2018.16以来的相关信息
九江银行股份有限公司鄱阳支行	江西省无;上饶市人社局没有搜索栏，行政处罚公示栏无2018.17以来的相关信息
九江银行股份有限公司上饶万达广场社区支行	江西省无;上饶市人社局没有搜索栏，行政处罚公示栏无2018.18以来的相关信息
九江银行股份有限公司玉山支行	江西省无;上饶市人社局没有搜索栏，行政处罚公示栏无2018.19以来的相关信息
九江银行股份有限公司婺源支行	江西省无;上饶市人社局没有搜索栏，行政处罚公示栏无2018.20以来的相关信息
九江银行股份有限公司弋阳支行	江西省无;上饶市人社局没有搜索栏，行政处罚公示栏无2018.21以来的相关信息
九江银行股份有限公司铅山支行	江西省无;上饶市人社局没有搜索栏，行政处罚公示栏无2018.22以来的相关信息
九江银行股份有限公司横峰支行	江西省无;上饶市人社局没有搜索栏，行政处罚公示栏无2018.23以来的相关信息
九江银行股份有限公司新余分行	江西省无;新余市无
九江银行股份有限公司新余北湖星城社区支行	江西省无;新余市无
九江银行股份有限公司新余苗圃星城社区支行	江西省无;新余市无
九江银行股份有限公司新余名仕公馆社区支行	江西省无;新余市无
九江银行股份有限公司新余抱石公园小微支行	江西省无;新余市无
九江银行股份有限公司渝水支行	江西省无;新余市无
九江银行股份有限公司分宜支行	江西省无;新余市无
九江银行股份有限公司宜春分行	江西省无;宜春市无
九江银行股份有限公司高安支行	江西省无;宜春市无
九江银行股份有限公司丰城支行	江西省无;宜春市无
九江银行股份有限公司樟树支行	江西省无;宜春市无
九江银行股份有限公司上高支行	江西省无;宜春市无
九江银行股份有限公司宜春名爵豪苑社区支行	江西省无;宜春市无
九江银行股份有限公司宜春阳光新城社区支行	江西省无;宜春市无
九江银行股份有限公司奉新支行	江西省无;宜春市无
九江银行股份有限公司袁州支行	江西省无;宜春市无
九江银行股份有限公司万载支行	江西省无;宜春市无
九江银行股份有限公司剑邑支行	江西省无;宜春市无
九江银行股份有限公司铜鼓支行	江西省无;宜春市无
九江银行股份有限公司宜丰支行	江西省无;宜春市无
九江银行股份有限公司宜春东风小微支行	江西省无;宜春市无
九江银行股份有限公司高安瑞州小微支行	江西省无;宜春市无
九江银行股份有限公司樟树锦绣共和小微支行	江西省无;宜春市无
九江银行股份有限公司宜春双桥社区支行	江西省无;宜春市无
九江银行股份有限公司靖安支行	江西省无;宜春市无
九江银行股份有限公司十运支行	江西省无;宜春市无
九江银行股份有限公司鹰潭分行	江西省无;鹰潭市人社局无搜索栏，行政处罚公示无九江银行相关信息
九江银行股份有限公司鹰潭恒大社区支行	江西省无;鹰潭市人社局无搜索栏，行政处罚公示无九江银行相关信息
九江银行股份有限公司贵溪支行	江西省无;鹰潭市人社局无搜索栏，行政处罚公示无九江银行相关信息
九江银行股份有限公司鹰潭水岸华府小微支行	江西省无;鹰潭市人社局无搜索栏，行政处罚公示无九江银行相关信息
九江银行股份有限公司余江支行	江西省无;鹰潭市人社局无搜索栏，行政处罚公示无九江银行相关信息
九江银行股份有限公司月湖支行	江西省无;鹰潭市人社局无搜索栏，行政处罚公示无九江银行相关信息
九江银行股份有限公司赣江新区分行	江西省无;赣江新区官网无
九江银行股份有限公司资金营运中心	江西省无;南昌市无
北京大兴九银村镇银行股份有限公司	北京市无;大兴区无
北京大兴九银村镇银行股份有限公司兴业路支行	北京市无;大兴区无
北京大兴九银村镇银行股份有限公司旧宫支行	北京市无;大兴区无
北京大兴九银村镇银行股份有限公司采育支行	北京市无;大兴区无
北京大兴九银村镇银行股份有限公司魏善庄支行	北京市无;大兴区无
北京大兴九银村镇银行股份有限公司亦庄支行	北京市无;大兴区无
北京大兴九银村镇银行股份有限公司礼贤支行	北京市无;大兴区无
北京大兴九银村镇银行股份有限公司芦城支行	北京市无;大兴区无
修水九银村镇银行有限责任公司	江西省无;九江市无;修水县无
修水九银村镇银行有限责任公司站前路支行	江西省无;九江市无;修水县无
修水九银村镇银行有限责任公司太阳升支行	江西省无;九江市无;修水县无
修水九银村镇银行有限责任公司渣津支行	江西省无;九江市无;修水县无
井冈山九银村镇银行有限责任公司	江西省无;吉安市无;井冈山无
井冈山九银村镇银行有限责任公司龙市支行	江西省无;吉安市无;井冈山无
井冈山九银村镇银行有限责任公司茨坪支行	江西省无;吉安市无;井冈山无
井冈山九银村镇银行有限责任公司厦坪支行	江西省无;吉安市无;井冈山无
日照九银村镇银行股份有限公司	山东省无;日照市无
日照九银村镇银行股份有限公司巨峰支行	山东省无;日照市无
日照九银村镇银行股份有限公司高兴支行	山东省无;日照市无
日照九银村镇银行股份有限公司南小庄支行	山东省无;日照市无
日照九银村镇银行股份有限公司虎山支行	山东省无;日照市无
日照九银村镇银行股份有限公司黄墩支行	山东省无;日照市无
日照九银村镇银行股份有限公司涛雒支行	山东省无;日照市无
南京六合九银村镇银行股份有限公司	江苏省无;南京市无;六合区无
南京六合九银村镇银行股份有限公司大厂支行	江苏省无;南京市无;六合区无
南京六合九银村镇银行股份有限公司金牛湖支行	江苏省无;南京市无;六合区无
南昌昌东九银村镇银行股份有限公司	江西省无;九江市无;瑞昌县无
南昌昌东九银村镇银行股份有限公司麻丘支行	江西省无;抚州市无;资溪县无
彭泽九银村镇银行股份有限公司	江西省无;抚州市无;崇仁县无
瑞昌九银村镇银行股份有限公司	江西省无;新余市无;分宜县无
资溪九银村镇银行股份有限公司	江西省无;宜春市无;奉新县无
崇仁九银村镇银行股份有限公司	江西省无;宜春市无;靖安县无
分宜九银村镇银行股份有限公司	江西省无;景德镇无;昌江无
奉新九银村镇银行股份有限公司	江西省无;宜春市无;铜鼓县无
靖安九银村镇银行股份有限公司	江西省无;九江市无;庐山县无
景德镇昌江九银村镇银行股份有限公司	江西省无;九江市无;湖口县无
铜鼓九银村镇银行股份有限公司	江西省无;九江市无;都昌县无
庐山九银艺术村镇银行股份有限公司	江西省无;九江市无;庐山县无
湖口九银村镇银行股份有限公司	江西省无;九江市无;湖口县无
都昌九银村镇银行股份有限公司	江西省无;九江市无;都昌县无
